32
64
1111111111111111111111111111111111111111111111111111111111111111
1000000000000000000000000000000000000000000000000000000000000001
1000000000000200000000000000000000000000000000000000000000000001
1000000000000200000000000000000000000000000000000000000000000001
1000000000000200000000000001111111111111111100000000000000000001
1000000222222222222000000001000000000000000000000000000000000001
1000000000000200000000000001000000000000000000000000000000000001
1000000000000200000000000001000000000000000000000000000000000001
1000000000000200000000000001000000000002222222222200000000000001
1000000000000000000000000001000000000000000000000000000000000001
1000000000000000000000000001000000000000000000000000000000000001
1000000000000000000000000000000000000000000000000000000000000001
1000000011111111111100000000000000000000000000000000000000000001
1000000000000000000000000000000000000000000000000000000000000001
1000000000000000000000000000000000001000000000000000000000000001
1000000000000000000000000000000000001000000000000000000000000001
1000000000000000000000000000000000001000000000000000000000000001
1000000000000000000000000000000000001000000000000000000000000001
1000000000000333333000000000000000001000000000011111111111111111
1000000000000000000000000000000000000000000000000000000000000001
1000000000000000000000000000000000000000000000000000000000000001
1000000000000000000000000000000000000000000000000000000000000001
1000001000000000000000000000000000000000000000000000000000000001
1000001000000001111111111000000000000000100000000000000000000001
1000001000000000000400000000000000000000100000000000000000000001
1000001000000000000400000000000000000000100000000000000000000001
1000001000000000000400000000000000000000100000000000000000000001
1000001000000000000400000000000000000000111111000000000000000001
1000001000000000000400005555555555555000000000000000000000000001
1000000000000000000000000000000000000000000000000000000000000001
1000000000000000000000000000000000000000000000000000000000000001
1111111111111111111111111111111111111111111111111111111111111111